{
  "map": [
    [1, 1, 1, 1, 1, 1, 1, 1, 1, 1, 1],
    [1, 0, 0, 1, 0, 1, 0, 0, 1, 0, 1],
    [1, 0, 0, 0, 1, 1, 0, 0, 1, 0, 1],
    [1, 0, 0, 0, 0, 1, 1, 0, 1, 0, 1],
    [1, 1, 0, 1, 0, 1, 0, 0, 0, 0, 1],
    [1, 0, 0, 1, 0, 0, 0, 0, 1, 0, 1],
    [1, 0, 1, 1, 0, 1, 0, 0, 1, 0, 1],
    [1, 0, 0, 1, 1, 1, 0, 0, 1, 1, 1],
    [1, 0, 0, 0, 0, 0, 0, 0, 0, 0, 1],
    [1, 0, 1, 0, 0, 1, 0, 0, 1, 0, 1],
    [1, 1, 1, 1, 1, 1, 1, 1, 1, 1, 1]
  ],
  "start": {
    "x": 9,
    "y": 9
  }
}
